20
20
 01234567890123456789
OOOOOOOOOOOOOXOOOOOX
OXXXOXXOXXXXOXXOXXOX
4\OXXXOOOOOXXXOOOOXXXX
6OXXXOXXXXXXXOXXXXOOX
8OXXXOXXXXXXXOXXOOOXX
0OOOOXXXOOOOOOOOOXOXX
2OXXXXOXOXXXXXXXXXOXX
4OOOOOOXOXOOOOOOOOOXX
6OXXXXXXOXXOXXXXXXXXX
8OOOOOOOOXXOOOOOOOXXX
0OXXXOXXXXXXXOXXXOOOO
2OXOXOXOOOOOOOXXXOXXO
4OXOXXXOXOXXOXOOOOXXO
6OOOOOOOXXXXXXOXXOXXO
8XOXXXXXXOOOOXOXXOXXX
0XOXOOXXOOXXOXOOXOOOX
2XOXXOXXOXXXOXXXXXXOX
4XOXXOOOOOXXOXXOOOOOX
6XOOOOXXXXXXOXXOXXXXX
8XOXXOXOOOOOOOOOOOOOOZ
